-- This file is automatically generated. You should know what you did if you want to edit this
-- !q04 --
AAAAAAAAAAABBAAA	Donald	Brewer	Y
AAAAAAAAAAACCAAA	Terry	Simmons	N
AAAAAAAAAAACHBAA	Francis	Thompson	Y
AAAAAAAAAAACIAAA	Evelyn	Ferris	Y
AAAAAAAAAAACJBAA	Kenneth	Bragg	N
AAAAAAAAAAAEABAA			
AAAAAAAAAAAFCAAA	Nathan	Moore	N
AAAAAAAAAAAGKBAA	Leslie	Lee	Y
AAAAAAAAAAAGLAAA	Stephanie	Allen	N
AAAAAAAAAAAHLBAA	George	Belt	N
AAAAAAAAAAAIJAAA	Nellie	Hughes	N
AAAAAAAAAAAJEBAA	Magdalena	Steward	N
AAAAAAAAAAAJHAAA	Anne	Chambliss	N
AAAAAAAAAAAJKBAA	Linda	Moore	N
AAAAAAAAAAAODBAA	Barbara	Newby	Y
AAAAAAAAAAAOHAAA		Williams	Y
AAAAAAAAAAAOJAAA	Timothy	Williams	N
AAAAAAAAAABANAAA	Vanessa	Rubio	Y
AAAAAAAAAABBDAAA	Barbara	White	Y
AAAAAAAAAABBGAAA	Cheryl	Forest	Y
AAAAAAAAAABBIAAA	Isaac	Collins	N
AAAAAAAAAABBMBAA	Larry	Blair	Y
AAAAAAAAAABCDBAA	Jeffrey	Knapp	Y
AAAAAAAAAABCEAAA	Alice	Gibbons	N
AAAAAAAAAABCOAAA	Cheryl	Green	Y
AAAAAAAAAABEHAAA	Steve	Pratt	N
AAAAAAAAAABEPAAA	Marjorie	Quinn	Y
AAAAAAAAAABFEBAA	Eric	Melton	Y
AAAAAAAAAABFHBAA	Sherri	Caballero	Y
AAAAAAAAAABFMBAA	Lashay	Schreiner	Y
AAAAAAAAAABGKAAA	Victor	Robinson	Y
AAAAAAAAAABHDBAA	Christopher	Thomas	N
AAAAAAAAAABKDAAA	Dave	Francis	Y
AAAAAAAAAABKFBAA	Megan	Dykes	N
AAAAAAAAAABKMBAA	Velma	Thompson	Y
AAAAAAAAAABMNAAA	Shellie	Green	Y
AAAAAAAAAABOCAAA	Jesus	Taylor	N
AAAAAAAAAABOIBAA	Melissa	Thompson	N
AAAAAAAAAABPHBAA	Rebecca	Coleman	N
AAAAAAAAAABPPAAA	Michael	Somers	N
AAAAAAAAAACABBAA	Timothy	Gonzalez	Y
AAAAAAAAAACANAAA	Jane	Odum	N
AAAAAAAAAACBIBAA	Ben	Jordan	N
AAAAAAAAAACBMBAA	Stephen	Brown	N
AAAAAAAAAACCIAAA	Gretchen	Dellinger	Y
AAAAAAAAAACCJBAA	Casey	Dale	Y
AAAAAAAAAACCLAAA	Marlene		
AAAAAAAAAACFABAA	Charlotte	Knutson	Y
AAAAAAAAAACFOAAA	Matthew	Mcmanus	Y
AAAAAAAAAACGBAAA	Joshua	Wood	N
AAAAAAAAAACHGAAA	Rachel	Martindale	N
AAAAAAAAAACHLAAA	Betty	Thompson	N
AAAAAAAAAACIABAA	Judith	Hall	Y
AAAAAAAAAACNBAAA	Tyler	Osborne	N
AAAAAAAAAACNEAAA	Scott		
AAAAAAAAAACONBAA	John	Wells	Y
AAAAAAAAAADBPAAA	Fred	Stevens	Y
AAAAAAAAAADCDAAA	Nicholas	Brown	Y
AAAAAAAAAADCGAAA	Paul	White	N
AAAAAAAAAADEJBAA	Teresa	Sparks	Y
AAAAAAAAAADFDAAA	Randall	Smith	N
AAAAAAAAAADFGBAA	Tyler	Davis	N
AAAAAAAAAADGAAAA	Ann	Mcnamee	Y
AAAAAAAAAADGDAAA	Alice	Holland	Y
AAAAAAAAAADGEBAA	Richard	Novak	N
AAAAAAAAAADGFBAA	Reginald	Lenz	N
AAAAAAAAAADHBAAA	Juan	Ball	Y
AAAAAAAAAADHEBAA	Shauna	Villarreal	N
AAAAAAAAAADHHBAA	Jennifer	Scott	N
AAAAAAAAAADIJAAA	Jason	Baylor	N
AAAAAAAAAADJLBAA	Theresa	Terry	N
AAAAAAAAAADKBBAA	Edward	Jenkins	N
AAAAAAAAAADKCBAA	Edward	Casey	N
AAAAAAAAAADLEAAA	Josette	Lopez	N
AAAAAAAAAADLLBAA	Gene	Boyd	N
AAAAAAAAAADMNAAA	Phillip	Boyd	Y
AAAAAAAAAADNNAAA	Ernest	Lowe	Y
AAAAAAAAAADOOAAA	Ronald	Chappell	N
AAAAAAAAAADPFAAA	Lina	Atkinson	Y
AAAAAAAAAAEBEBAA	Jose	Monk	Y
AAAAAAAAAAEBFBAA	Kevin	Caldwell	Y
AAAAAAAAAAECLAAA	Brian	Schrader	N
AAAAAAAAAAECLBAA	Ray	Smith	N
AAAAAAAAAAECMBAA	Brandon	Spencer	Y
AAAAAAAAAAEDBBAA	Nilda	Smith	Y
AAAAAAAAAAEDDAAA	Randall	Hall	Y
AAAAAAAAAAEDNBAA	Edward	Ward	Y
AAAAAAAAAAEEABAA	Rodolfo	Cody	Y
AAAAAAAAAAEFABAA	Marsha	Brooks	Y
AAAAAAAAAAEFEBAA	Allison	Worthington	N
AAAAAAAAAAEFJAAA	Bobby	Ferguson	Y
AAAAAAAAAAEHKBAA	William	Hill	
AAAAAAAAAAEHOBAA		Vallejo	
AAAAAAAAAAEIHAAA	Louise	Kline	N
AAAAAAAAAAEKKAAA	Darcy	Cash	Y
AAAAAAAAAAEKNAAA	Tricia	Gonzalez	Y
AAAAAAAAAAELCBAA	Edward	Lewis	Y
AAAAAAAAAAELPAAA	Maxine	Hilton	Y
AAAAAAAAAAEMBAAA	Jerry	Kaplan	N
AAAAAAAAAAEMDAAA	Donna	Rivera	N

