-- This file is automatically generated. You should know what you did if you want to edit this
-- !q74 --
AAAAAAAAAAAADAAA	Kathryn	Thompson
AAAAAAAAAAAAEAAA	Robert	Patterson
AAAAAAAAAAAALAAA	Cathy	Salinas
AAAAAAAAAAABMAAA	Darrin	Williams
AAAAAAAAAAABMBAA	Jacqueline	Carlson
AAAAAAAAAAACBBAA	George	Beck
AAAAAAAAAAACGBAA	Margaret	Bender
AAAAAAAAAAACJBAA	Kenneth	Bragg
AAAAAAAAAAACOBAA	Sandra	Cowan
AAAAAAAAAAAEDAAA	Paula	Ferguson
AAAAAAAAAAAEEAAA	Richard	Jolley
AAAAAAAAAAAFEBAA	Elizabeth	Gordon
AAAAAAAAAAAFNBAA	Jeanette	Burnett
AAAAAAAAAAAGCBAA	Gregory	Goodwin
AAAAAAAAAAAGJBAA	Allison	Peebles
AAAAAAAAAAAGLAAA	Stephanie	Allen
AAAAAAAAAAAGPAAA	Gwendolyn	Prosser
AAAAAAAAAAAHDAAA	Joyce	John
AAAAAAAAAAAHGBAA	William	Hernandez
AAAAAAAAAAAHJAAA	William	Heck
AAAAAAAAAAAIIAAA	Ashley	Shannon
AAAAAAAAAAAIJAAA	Nellie	Hughes
AAAAAAAAAAAIMAAA	Barbara	
AAAAAAAAAAAINBAA	Salina	Harper
AAAAAAAAAAAJEBAA	Magdalena	Steward
AAAAAAAAAAAJHAAA	Anne	Chambliss
AAAAAAAAAAAJJAAA	Kimberly	Phillips
AAAAAAAAAAAJNBAA	William	Montoya
AAAAAAAAAAAJOAAA	Stephen	Smith
AAAAAAAAAAAKABAA	Carla	Chase
AAAAAAAAAAALCAAA	Jeffrey	Harrison
AAAAAAAAAAALEBAA	Marie	Ornelas
AAAAAAAAAAAMCBAA		Smith
AAAAAAAAAAAMLBAA	Bennie	Peters
AAAAAAAAAAAMMAAA	Thomas	Hanlon
AAAAAAAAAAANABAA	Dena	Cox
AAAAAAAAAAANCAAA	Michael	Lachance
AAAAAAAAAAANJBAA	Melvin	Baird
AAAAAAAAAAAODBAA	Barbara	Newby
AAAAAAAAAAAOGBAA	Bonnie	Burge
AAAAAAAAAAAOHAAA		Williams
AAAAAAAAAAAOKBAA	Tara	Libby
AAAAAAAAAABAFBAA	Susan	Wood
AAAAAAAAAABALBAA	Thomas	Pate
AAAAAAAAAABANAAA	Vanessa	Rubio
AAAAAAAAAABAOBAA	Jose	Chavez
AAAAAAAAAABBDAAA	Barbara	White
AAAAAAAAAABBDBAA	Anthony	Webb
AAAAAAAAAABBEBAA	Michael	Grossman
AAAAAAAAAABBGAAA	Cheryl	Forest
AAAAAAAAAABBHBAA	Wendy	Guillen
AAAAAAAAAABBJBAA	Gerald	Christenson
AAAAAAAAAABBMBAA	Larry	Blair
AAAAAAAAAABCCBAA	Emily	Cole
AAAAAAAAAABCDAAA	Jennifer	Mclaughlin
AAAAAAAAAABCIBAA	Lisa	Luckett
AAAAAAAAAABCOAAA	Cheryl	Green
AAAAAAAAAABDCAAA	Deborah	Miller
AAAAAAAAAABDKAAA	Lorraine	Mckinley
AAAAAAAAAABDOAAA	Charles	Jackson
AAAAAAAAAABEBAAA	Lisa	Weaver
AAAAAAAAAABEEBAA	Mark	
AAAAAAAAAABEHAAA	Steve	Pratt
AAAAAAAAAABEMBAA	Willie	Echevarria
AAAAAAAAAABEPAAA	Marjorie	Quinn
AAAAAAAAAABFCAAA	Bennett	Watson
AAAAAAAAAABFHAAA	Odessa	Ring
AAAAAAAAAABFHBAA	Sherri	Caballero
AAAAAAAAAABGFBAA	Tim	Morse
AAAAAAAAAABGKAAA	Victor	Robinson
AAAAAAAAAABGNBAA	Lino	Bivens
AAAAAAAAAABIIBAA		Thompson
AAAAAAAAAABILAAA	Alex	Gonzalez
AAAAAAAAAABINBAA	Jesus	Mathis
AAAAAAAAAABJBBAA	Alice	Barton
AAAAAAAAAABJMAAA	Amy	Brackett
AAAAAAAAAABKCAAA	Amanda	Bourgeois
AAAAAAAAAABKJBAA	Monique	Walters
AAAAAAAAAABKMBAA	Velma	Thompson
AAAAAAAAAABLCAAA		
AAAAAAAAAABLEBAA	Mayra	Oconner
AAAAAAAAAABLKBAA	Jessica	Beaver
AAAAAAAAAABNAAAA	Gary	Johnson
AAAAAAAAAABNHBAA	Brian	Thurston
AAAAAAAAAABNNBAA	Herbert	Watts
AAAAAAAAAABNPAAA	Dale	Fulton
AAAAAAAAAABOABAA	Robert	Rankin
AAAAAAAAAABOEAAA	Joshua	Velazquez
AAAAAAAAAABOIBAA	Melissa	Thompson
AAAAAAAAAABPHBAA	Rebecca	Coleman
AAAAAAAAAACABBAA	Timothy	Gonzalez
AAAAAAAAAACAOAAA	Tim	Roberson
AAAAAAAAAACBMBAA	Stephen	Brown
AAAAAAAAAACBNAAA	Nestor	Willoughby
AAAAAAAAAACCEBAA	Nick	Swartz
AAAAAAAAAACCGAAA	Brian	Mason
AAAAAAAAAACCIAAA	Gretchen	Dellinger
AAAAAAAAAACCLBAA	Arnoldo	Doucette
AAAAAAAAAACDJBAA	Barbara	Sanchez
AAAAAAAAAACDMBAA	Joseph	George

