-- This file is automatically generated. You should know what you did if you want to edit this
-- !explicit_inner_join_select_where_order --
EGYPT	MIDDLE EAST
ETHIOPIA	AFRICA
FRANCE	EUROPE
GERMANY	EUROPE
INDIA	ASIA
INDONESIA	ASIA
IRAN	MIDDLE EAST
IRAQ	MIDDLE EAST
JAPAN	ASIA
JORDAN	MIDDLE EAST
KENYA	AFRICA
MOROCCO	AFRICA
MOZAMBIQUE	AFRICA
PERU	AMERICA
ROMANIA	EUROPE
RUSSIA	EUROPE
SAUDI ARABIA	MIDDLE EAST
UNITED KINGDOM	EUROPE
UNITED STATES	AMERICA
VIETNAM	ASIA

