-- This file is automatically generated. You should know what you did if you want to edit this
-- !left_outer_join --
ALGERIA	AFRICA
ARGENTINA	AMERICA
BRAZIL	ASIA
CANADA	EUROPE
EGYPT	MIDDLE EAST
ETHIOPIA	\N
FRANCE	\N
GERMANY	\N
INDIA	\N
INDONESIA	\N
IRAN	\N
IRAQ	\N
JAPAN	\N
JORDAN	\N
KENYA	\N
MOROCCO	\N
MOZAMBIQUE	\N
PERU	\N
CHINA	\N
ROMANIA	\N
SAUDI ARABIA	\N
VIETNAM	\N
RUSSIA	\N
UNITED KINGDOM	\N
UNITED STATES	\N

