-- This file is automatically generated. You should know what you did if you want to edit this
-- !right_outer_join --
CANADA	EUROPE
BRAZIL	ASIA
ARGENTINA	AMERICA
ALGERIA	AFRICA
EGYPT	MIDDLE EAST
MOROCCO	\N
UNITED STATES	\N
VIETNAM	\N
ETHIOPIA	\N
INDIA	\N
CHINA	\N
JAPAN	\N
RUSSIA	\N
IRAQ	\N
FRANCE	\N
PERU	\N
ROMANIA	\N
INDONESIA	\N
SAUDI ARABIA	\N
KENYA	\N
MOZAMBIQUE	\N
IRAN	\N
GERMANY	\N
UNITED KINGDOM	\N
JORDAN	\N

